....................
....................
####....###.........
....................
....................
.....###.GGG........
.........GGG........
....GGG..GGG..GGG...
####GGG..###..GGG...
....GGG.......GGG...
....GGG.......GGG...
GGGG###GGGGGGG###GGG
GGGGGGGGGGGGGGGGGGGG
.1GGGGGGGGGGGGGGGGX.
##..################
